6 5
 1 1 1 1 1
1 1 1 1 0 1
 0 0 0 0 1
1 0 0 0 0 1
 0 1 1 0 1
1 1 0 0 1 1
 1 1 1 0 0
1 0 1 1 1 1
 0 0 0 0 0
1 1 1 1 0 1
 0 1 0 0 0
1 0 0 0 1 1
 1 1 1 1 1
3
4 5
5 2
3 3